Atrakcyjność turystyczna:
Właściwość obszaru lub miejscowości wynikająca 
z zespołu cech przyrodniczych lub pozaprzyrodniczych, 
która decyduje o zainteresowaniu ze strony turystów. 
O stopniu atrakcyjności turystycznej 
danego obszaru lub miejscowości decydują:
a)walory turystyczne,
b)zagospodarowanie turystyczne,
c)dostępność komunikacyjna.

Wskazniki funkcji turystycznej:
a) wskaźniki intensywności ruchu turystycznego,
b) wskaźniki zagospodarowania turystycznego,
c) syntetyczne wskaźniki funkcji turystycznej.

Wyzwanie wspołczesnej turystyki:
Kryzysy polityczne, Pandemii, Inflacja  

Overturyzm
wpływ turystyki na miejsce docelowe lub jego część, 
który nadmiernie negatywnie wpływa na postrzeganą 
jakość życia obywateli i/lub jakość wrażeń odwiedzających

Stolice:
Albania - Tirana
Andorra - Andorra la Vella
Armenia - Yerevan
Austria - Vienna
Azerbaijan - Baku
Belarus - Minsk
Belgium - Brussels
Bosnia and Herzegovina - Sarajevo
Bulgaria - Sofia
Croatia - Zagreb
Cyprus - Nicosia
Czech Republic - Prague
Denmark - Copenhagen
Estonia - Tallinn
Finland - Helsinki
France - Paris
Georgia - Tbilisi
Germany - Berlin
Greece - Athens
Hungary - Budapest
Iceland - Reykjavik
Ireland - Dublin
Italy - Rome
Kazakhstan - Nur-Sultan (formerly Astana)
Kosovo - Pristina
Latvia - Riga
Liechtenstein - Vaduz
Lithuania - Vilnius
Luxembourg - Luxembourg City
Malta - Valletta
Moldova - Chisinau
Monaco - Monaco
Montenegro - Podgorica
Netherlands - Amsterdam
North Macedonia - Skopje
Norway - Oslo
Poland - Warsaw
Portugal - Lisbon
Romania - Bucharest
Russia - Moscow
San Marino - San Marino
Serbia - Belgrade
Slovakia - Bratislava
Slovenia - Ljubljana
Spain - Madrid
Sweden - Stockholm
Switzerland - Bern
Turkey - Ankara
Ukraine - Kyiv
United Kingdom - London
Vatican City - Vatican City
